3 3 1 1 1 1 1 1 1 1 1 1 1 1 1 1 1 1 1 3 2 5 4 4 2 2 2 2 2 2 2 2 2 2 2 2 2 2 2 0 0 0 0 0 4 5 5 5 5 5 
3 1 1 1 1 1 1 1 1 1 1 1 3 3 3 3 3 3 3 2 2 5 5 4 2 4 4 4 4 2 4 4 4 4 4 4 4 4 4 4 4 4 4 4 4 5 5 5 5 5 
1 1 1 1 1 1 1 3 3 3 3 3 3 3 3 3 3 2 2 5 5 5 5 4 2 4 4 2 2 2 2 2 2 2 2 4 2 2 2 2 2 0 0 1 4 5 5 3 5 5 
1 1 1 1 1 3 3 3 3 3 3 3 3 3 3 2 2 5 5 5 0 0 5 4 2 2 4 2 2 2 2 2 2 2 2 4 2 2 2 2 2 2 0 1 4 5 5 1 5 5 
1 1 1 1 1 3 3 3 3 3 3 3 3 3 2 2 0 5 0 0 0 5 5 4 4 2 4 2 2 2 2 2 2 2 2 2 2 2 2 2 2 2 2 1 4 5 5 1 5 5 
1 1 1 3 3 3 3 3 3 3 3 3 3 2 2 2 0 5 0 5 5 5 0 0 4 2 4 4 2 2 2 2 2 2 2 4 2 2 2 2 2 2 2 1 4 4 4 1 4 4 
1 1 1 3 3 3 3 3 3 3 3 3 3 2 2 2 5 5 0 5 5 0 0 4 4 2 2 4 2 2 2 2 2 2 2 4 2 2 2 2 2 2 2 1 1 1 1 1 1 1 
1 1 1 3 3 3 3 3 3 3 3 2 2 2 2 5 5 0 0 5 5 0 4 4 4 2 2 4 4 2 2 2 2 2 2 4 2 2 2 2 2 2 2 1 1 1 1 1 1 1 
1 1 1 3 3 3 3 3 3 3 3 2 2 2 2 5 5 0 5 5 5 0 4 2 2 2 2 2 4 2 2 2 2 2 4 4 2 2 2 2 2 2 2 2 2 1 1 1 1 1 
1 1 1 3 3 3 3 3 3 3 2 2 2 2 0 5 5 0 5 5 5 0 4 2 2 2 2 2 4 4 4 4 4 4 4 2 2 2 2 2 2 2 2 2 2 2 1 1 1 1 
1 1 3 3 3 3 3 3 3 2 2 2 2 2 0 5 0 0 5 5 5 0 4 2 1 1 1 1 1 1 1 1 1 1 1 1 1 1 1 1 1 1 1 1 1 1 1 1 1 1 
1 1 3 3 3 3 3 2 2 2 2 2 2 2 0 5 0 5 5 5 5 0 4 2 1 1 1 2 2 4 4 4 4 4 4 4 2 2 2 2 2 2 2 2 2 2 2 2 1 1 
1 1 3 3 3 2 2 2 2 2 2 2 2 2 0 5 0 5 5 5 0 0 4 2 2 2 2 2 2 4 2 2 2 2 2 2 2 2 2 2 2 2 2 2 2 2 2 2 1 1 
1 1 3 3 2 2 2 2 2 2 2 2 2 2 0 0 0 5 0 0 0 0 4 2 2 2 2 2 2 4 2 1 1 1 1 1 1 1 1 1 1 1 1 1 1 1 1 2 1 1 
1 3 3 2 2 2 2 2 2 2 2 2 2 2 0 5 5 5 0 4 4 4 4 4 4 4 4 4 2 4 2 1 2 2 2 2 2 2 2 2 2 2 2 2 2 2 1 2 1 1 
1 3 3 2 2 2 2 2 2 2 2 2 2 2 0 0 0 0 2 2 2 2 2 2 2 2 2 4 2 4 2 1 2 2 2 2 2 2 2 2 2 2 2 2 2 2 1 2 1 1 
1 1 3 3 2 2 2 2 2 2 2 2 2 2 0 5 5 5 5 4 2 2 2 2 2 2 2 4 2 4 2 1 2 2 2 2 2 2 2 2 2 2 2 2 2 2 1 2 1 1 
1 1 3 3 3 3 2 2 2 2 2 2 2 2 0 0 0 0 0 4 2 2 2 2 2 2 2 4 2 4 2 1 2 2 2 2 2 2 2 2 2 2 2 2 2 2 1 2 1 1 
1 1 3 3 3 3 2 2 2 2 2 2 2 2 5 5 5 5 0 4 4 2 2 2 2 2 2 4 2 4 2 1 2 2 2 2 2 2 2 2 2 2 2 2 2 2 1 2 1 1 
1 1 3 3 3 3 3 2 2 2 2 2 2 5 5 5 5 5 0 0 4 2 2 2 2 2 2 4 2 4 2 1 2 2 2 2 2 2 2 2 2 2 2 2 2 2 1 2 1 1 
1 1 3 3 3 3 3 2 2 2 2 2 2 5 5 5 5 0 0 0 4 2 2 2 2 2 2 4 2 4 2 1 1 2 2 2 2 2 2 2 2 2 2 2 2 2 1 2 1 1 
1 1 3 3 3 3 3 2 2 2 2 2 2 2 5 5 5 0 5 4 4 2 2 2 2 2 2 4 2 4 2 1 1 2 2 2 2 2 2 2 2 2 2 2 2 2 1 2 1 1 
1 1 1 3 3 3 3 3 2 2 2 5 5 5 5 5 5 0 5 4 4 4 4 2 4 4 4 4 2 4 2 2 1 1 1 1 1 1 2 2 2 1 1 1 1 1 1 2 1 1 
1 1 1 1 3 3 3 3 2 5 5 5 0 0 5 0 0 0 5 4 2 2 2 2 2 2 2 2 2 4 4 2 2 2 2 2 2 2 2 2 2 2 2 2 2 2 2 2 1 1 
1 1 1 1 3 3 3 3 2 5 5 5 5 0 5 5 5 0 5 4 2 4 4 4 4 4 4 4 4 4 4 4 4 4 4 4 4 4 4 4 4 4 4 4 4 4 4 4 1 1 
1 1 1 1 1 3 3 3 2 2 5 5 5 0 5 5 5 0 5 4 2 4 2 2 2 4 2 2 2 2 2 4 2 2 2 2 4 0 2 2 2 2 2 2 4 2 2 2 1 1 
1 1 1 1 1 1 3 3 3 2 5 5 5 0 5 5 5 0 5 4 2 4 2 2 2 4 2 2 2 2 2 4 2 2 2 2 0 0 2 2 2 2 2 2 4 2 2 2 1 1 
1 1 1 1 1 1 1 3 3 2 2 5 5 0 0 5 5 0 5 4 2 4 2 2 2 2 2 2 2 2 0 4 2 2 2 2 4 0 2 2 2 2 2 2 4 2 2 2 1 1 
3 1 1 1 1 1 1 1 3 3 2 2 5 5 0 5 5 0 5 4 2 4 2 2 2 4 2 2 2 0 0 4 4 4 4 4 4 4 4 4 4 4 4 2 4 2 2 2 1 1 
3 3 1 1 1 1 1 1 1 3 2 2 0 0 0 0 5 5 5 4 2 2 2 2 2 4 2 2 2 0 0 0 2 2 2 2 2 2 2 2 2 2 2 2 4 2 2 2 1 1 
